{
  "worlds": [
    "(1, 1, 1)",
    "(1, 1, 2)",
    "(1, 2, 1)",
    "(1, 2, 2)",
    "(2, 1, 1)",
    "(2, 1, 2)",
    "(2, 2, 1)",
    "(2, 2, 2)"
  ],
  "connection": [[ 23 , 20 ,  3  , 0 , 23,  20 ,  3  , 0],
    [ 20 , 20  , 0   ,0 , 20 , 20  , 0   ,0],
    [  3  , 0  , 3  , 0  , 3 ,  0  , 3  , 0],
    [  0 ,  0  , 0  , 0 ,  0 ,  0  , 0  , 0],
    [ 23 , 20  , 3  , 0, 123 ,120 ,103 ,100],
    [ 20 , 20  , 0  , 0 ,120, 120 ,100, 100],
    [  3 ,  0  , 3  , 0 ,103, 100, 103, 100],
    [  0 ,  0 ,  0   ,0, 100, 100, 100 ,100]]
}
